en hund	a dog	ä¸€åªç‹—
fÃ¶rst	first	ç¬¬ä¸€çš„
samtidigt	at the same time	åŒæ—¶
kan rÃ¤dda hennes liv	can save her life	å¯ä»¥æ•‘å¥¹çš„å‘½
can save her life	(dictapi HTTP 404)	å¯ä»¥æ•‘å¥¹çš„å‘½
ubiquitous	[adjective] Being everywhere at once: omnipresent. (e.g. To Hindus, Jews, Christians, and Muslims, God is ubiquitous.) ; [adjective] Appearing to be everywhere at once; being or seeming to be in more than one location at the same time. ; [adjective] Widespread; very prevalent.	æ— å¤„ä¸åœ¨çš„
ubiquitous	[adjective] Being everywhere at once: omnipresent. (e.g. To Hindus, Jews, Christians, and Muslims, God is ubiquitous.) ; [adjective] Appearing to be everywhere at once; being or seeming to be in more than one location at the same time. ; [adjective] Widespread; very prevalent.	æ— å¤„ä¸åœ¨çš„
dare	[noun] A challenge to prove courage. ; [noun] The quality of daring; venturesomeness; boldness. ; [noun] Defiance; challenge. ; [verb] To have enough courage (to do something). (e.g. I wouldn't dare argue with my boss.) ; [verb] To defy or challenge (someone to do something) (e.g. I dare you (to) kiss that girl.) ; [verb] To have enough courage to meet or do something, go somewhere, etc.; to face up to (e.g. Will you dare death to reach your goal?) ; [verb] To terrify; to daunt. ; [verb] To catch (larks) by producing terror through the use of mirrors, scarlet cloth, a hawk, etc., so that they lie still till a net is thrown over them.	æ•¢
dare	[noun] A challenge to prove courage. ; [noun] The quality of daring; venturesomeness; boldness. ; [noun] Defiance; challenge. ; [verb] To have enough courage (to do something). (e.g. I wouldn't dare argue with my boss.) ; [verb] To defy or challenge (someone to do something) (e.g. I dare you (to) kiss that girl.) ; [verb] To have enough courage to meet or do something, go somewhere, etc.; to face up to (e.g. Will you dare death to reach your goal?) ; [verb] To terrify; to daunt. ; [verb] To catch (larks) by producing terror through the use of mirrors, scarlet cloth, a hawk, etc., so that they lie still till a net is thrown over them.	æ•¢
gud	God	ä¸Šå¸
barn	children	å­©å­ä»¬
Ã¥terberÃ¤ttat		å¤è¿°
bÃ¤nder	ribbons	ä¸å¸¦
lÃ¤nge	long	é•¿çš„
rÃ¤dda	save	èŠ‚çœ
kÃ¶cker	kitchens	å¨æˆ¿
bÃ¶ker	barks	å å«
bÃ¶cker	books	å›¾ä¹¦
bÃ¶cker	books	å›¾ä¹¦
skriv	write	å†™
detalj	detail	ç»†èŠ‚
detalj	[1mdetail[22m	ç»†èŠ‚
teknik	[1mtechnique[22m	æŠ€æœ¯
eller	[1mor[22m	æˆ–è€…
eller	[word] or (e.g. Kaffe eller te?)	æˆ–è€…
skriva	[word] write (e.g. HÃ¤r Ã¤r skriva i en mening)	å†™
fÃ¶rsvunnen	[word] missing (e.g. HÃ¤r Ã¤r fÃ¶rsvunnen i en mening)	ä¸¢å¤±çš„
fÃ¶rsvunnen	[word] missing (e.g. HÃ¤r Ã¤r fÃ¶rsvunnen i en mening)	ä¸¢å¤±çš„
fÃ¶rsvunnen	[word] missing (e.g. HÃ¤r Ã¤r fÃ¶rsvunnen i en mening)	ä¸¢å¤±çš„
fÃ¶rsvunnen	[Adjective] missing, lost ; [Participle] past participle of fÃ¶rsvinna	ä¸¢å¤±çš„
svÃ¤rd	[Noun] a sword (e.g. Riddaren drog sitt svÃ¤rd)	å‰‘
sverige		
svenska		
sÃ¶der		
svenska	Swedish	ç‘å…¸
faktabÃ¶cker	fact books	äº‹å®ä¹¦
barn	children	å­©å­ä»¬
bra	Good	å¥½çš„
bra	Good	å¥½çš„
bra	Good	å¥½çš„
trovÃ¤rdig	[Adjective] credible, trustworthy (e.g. en trovÃ¤rdig kÃ¤lla)	å¯ä¿¡çš„
trovÃ¤rdig	[Adjective] credible, trustworthy (e.g. en trovÃ¤rdig kÃ¤lla)	å¯ä¿¡çš„
trovÃ¤rdig	[Adjective] credible, trustworthy (e.g. en trovÃ¤rdig kÃ¤lla)	å¯ä¿¡çš„
trovÃ¤rdig	[Adjective] credible, trustworthy (e.g. en trovÃ¤rdig kÃ¤lla)	å¯ä¿¡çš„
kvalitativ nyhetskÃ¤lla	[word] qualitative news source (e.g. Jag anvÃ¤nder 'kvalitativ nyhetskÃ¤lla' i svenska (I use 'kvalitativ nyhetskÃ¤lla' in Swedish))	å®šæ€§æ–°é—»æ¥æº
kvalitativ	[word] qualitative (e.g. Jag anvÃ¤nder 'kvalitativ' i svenska (I use 'kvalitativ' in Swedish))	å®šæ€§çš„
hus	[word] hus (e.g. Jag lÃ¤r mig svenska ord som 'hus')	æˆ¿å­
solig	[word] solig (e.g. Jag lÃ¤r mig svenska ord som 'solig')	é˜³å…‰æ˜åªš
en solig dag	[word] en solig dag (e.g. Jag lÃ¤r mig svenska ord som 'en solig dag')	ä¸€ä¸ªé˜³å…‰æ˜åªšçš„æ—¥å­
ledsen	[Adjective] sad (e.g. Hans kanin hade just dÃ¶tt, och han var ledsen och grÃ¤t)	å¯¹ä¸èµ·
kompisar	[Noun] indefinite plural of kompis	æœ‹å‹ä»¬
katastrof	[Noun] catastrophe (any large and disastrous event of great significance)	ç¾éš¾
fÃ¶rvÃ¥nar	[Verb] present indicative of fÃ¶rvÃ¥na	å¥‡æ€ª
tÃ¤nde	[Adjective] definite natural masculine singular of tÃ¤nd ; [Verb] past indicative of tÃ¤nda	ç‚¹äº®
hud	[word] hud (e.g. Jag lÃ¤r mig svenska ord som 'hud')	çš®è‚¤
fÃ¶rskÃ¶na	[word] fÃ¶rskÃ¶na (e.g. Jag lÃ¤r mig svenska ord som 'fÃ¶rskÃ¶na')	ç¾åŒ–
miljÃ¶	[word] miljÃ¶ (e.g. Jag lÃ¤r mig svenska ord som 'miljÃ¶')	ç¯å¢ƒ
komplex	[word] komplex (e.g. Jag lÃ¤r mig svenska ord som 'komplex')	å¤æ‚çš„
maskin	[word] maskin (e.g. Jag lÃ¤r mig svenska ord som 'maskin')	æœºå™¨
fantastisk	[word] fantastisk (e.g. Jag lÃ¤r mig svenska ord som 'fantastisk')	æå¥½çš„
sjunga	[word] sjunga (e.g. Jag lÃ¤r mig svenska ord som 'sjunga')	å”±æ­Œ
rÃ¤tter	[Adjective]  right; modern Swedish rÃ¤tt ; [Noun] indefinite plural of rÃ¤tt	èœè‚´
champinjon	[substantiv] champinjon (e.g. Jag anvÃ¤nder 'champinjon' pÃ¥ svenska) ; [substantiv] svamp (e.g. plocka bÃ¤r och svamp (pick berries and mushrooms))	è˜‘è‡
bad	[word] bad (e.g. Jag lÃ¤r mig svenska ord som 'bad')	æ´—æ¾¡
svamp	[substantiv] svamp (e.g. plocka bÃ¤r och svamp (pick berries and mushrooms))	è˜‘è‡
fÃ¶rvandlades till skrot (the car was turned into scrap))	æ”¹å˜
bli	[verb] bli (e.g. bli lÃ¤rare (become a teacher),)	å¾—åˆ°
lycka	[word] lycka (e.g. Jag lÃ¤r mig svenska ord som 'lycka')	å¹¸ç¦æ„Ÿ
byta	[verb] byta (e.g. vill du byta plats med mig? (would you mind changing places with me?),) ; [verb] fÃ¶rvandla (e.g. bilen fÃ¶rvandlades till skrot (the car was turned into scrap))	æ”¹å˜
tydligt	[adverb] tydligt (e.g. he told me explicitly (han sade uttryckligen till mig))	æ˜ç¡®åœ°
frÃ¥gade	[word] frÃ¥gade (e.g. Jag lÃ¤r mig svenska ord som 'frÃ¥gade')	è¯¢é—®
mÃ¥tt	[substantiv] mÃ¥tt (e.g. valdeltagandet Ã¤r ett mÃ¥tt pÃ¥ det politiska intresset (voting participation is a measure of political interest),) ; [substantiv] mÃ¥tt (e.g. jag hyser ett stort mÃ¥tt av sympati fÃ¶r det argumentet (I sympathize quite strongly with that argument))	æªæ–½
idÃ©	[substantiv] idÃ© (e.g. konstiga idÃ©er (strange ideas),) ; [verb] peka (e.g. allt pekar pÃ¥ att vi mÃ¥ste spara energi (everything points to our having to save energy),)	è§‚ç‚¹
skatta	[verb] skatta (e.g. antalet Ã¥skÃ¥dare skattades till fem tusen (the number of spectators was estimated at five thousand)) ; [substantiv] vÃ¤rde (e.g. bÃ¶cker till ett vÃ¤rde av tusen kronor (books to the value of (worth) one thousand kronor),)	ä»·å€¼
instantiate	[word] instantiate (e.g. Jag anvÃ¤nder 'instantiate' i svenska (I use 'instantiate' in Swedish))	å®ä¾‹åŒ–
inhÃ¤mta	[verb] inhÃ¤mta (e.g. en vÃ¤l inhÃ¤mtad kurs (studies well learned),)	è·å¾—
grund	[Adjective] shallow ; [Noun] ground, land (e.g. Huset Ã¤r byggt pÃ¥ ofri grund.)	åŸºæœ¬çš„
fadigt	[word] dull (e.g. Jag anvÃ¤nder 'fadigt' i svenska (I use 'fadigt' in Swedish))	ä¹å‘³çš„
fÃ¥rgel	[word] bird's eye (e.g. Jag anvÃ¤nder 'fÃ¥rgel' i svenska (I use 'fÃ¥rgel' in Swedish))	é¸Ÿç°
Det gÃ¥r att ansÃ¶ka redan nu men uppge dÃ¥ i ansÃ¶kan att hon vill bÃ¶rja i Mars eller sÃ¥ skickar ni er ansÃ¶kan efter Ã¥rsskiftet.	It is possible to apply already now, but state in the application that she wants to start in March or you will send your application after the end of the year.	ç°åœ¨å°±å¯ä»¥ç”³è¯·ï¼Œä½†åœ¨ç”³è¯·ä¸­æ³¨æ˜å¥¹å¸Œæœ›åœ¨ä¸‰æœˆä»½å¼€å§‹ï¼Œå¦åˆ™æ‚¨å°†åœ¨å¹´åº•åå‘é€ç”³è¯·ã€‚
tack fÃ¶r ditt snabba och tydliga svar! Vi kommer att ansÃ¶ka nÃ¥gra veckor innan hon reser tillbaka till Sverige. ha en trevlig helg!	[word] tack fÃ¶r ditt snabba och tydliga svar! Vi kommer att ansÃ¶ka nÃ¥gra veckor innan hon reser tillbaka till Sverige. ha en trevlig helg! (e.g. Jag lÃ¤r mig svenska ord som 'tack fÃ¶r ditt snabba och tydliga svar! Vi kommer att ansÃ¶ka nÃ¥gra veckor innan hon reser tillbaka till Sverige. ha en trevlig helg!')	æ„Ÿè°¢æ‚¨å¿«é€Ÿè€Œæ¸…æ™°çš„ç­”å¤ï¼æˆ‘ä»¬å°†åœ¨å¥¹è¿”å›ç‘å…¸å‰å‡ å‘¨æå‡ºç”³è¯·ã€‚ç¥ä½ å‘¨æœ«æ„‰å¿«ï¼
studie	[Noun] A study, an investigation, a report.	å­¦ä¹ 
kÃ¤mpa	[Verb] to fight (e.g. Riddaren kÃ¤mpade mot draken)	æ–—äº‰
nÃ¶jen	[Noun] indefinite plural of nÃ¶je	ä¹è¶£
vÃ¥ninge	[word] floor (e.g. Jag anvÃ¤nder 'vÃ¥ninge' i svenska (I use 'vÃ¥ninge' in Swedish))	åœ°é¢
fÃ¶rÃ¤lrar	[word] parents (e.g. Jag anvÃ¤nder 'fÃ¶rÃ¤lrar' i svenska (I use 'fÃ¶rÃ¤lrar' in Swedish))	çˆ¶æ¯
fÃ¶rÃ¤ldrar	[Noun] indefinite plural of fÃ¶rÃ¤lder	çˆ¶æ¯
arbetade	[Adjective] inflection of arbetad:
definite singular
plural ; [Verb] past indicative of arbeta	å·¥ä½œè¿‡
hammar	[word] hammer (e.g. Jag anvÃ¤nder 'hammar' i svenska (I use 'hammar' in Swedish))	é”¤
bilder	[word] bilder (e.g. Jag lÃ¤r mig svenska ord som 'bilder')	å›¾åƒ
ganska	[Adverb] pretty, quite, rather (e.g. Den hÃ¤r melonen Ã¤r ganska smaklÃ¶s)	ç›¸å½“
